XXXXXXXXXXXX
XXXX  XX   X
XX..  XX*  X
XX..  XX * X
XX..  * *  X
XX..  X XX X
XXXXX *  * X
    X   *  X
    XX  *  X
     X  X@XX
     XXXXXXX