XXXXXX
X.  .X
X * *X
X *  X
XX.X@X
 XXXXX